El Rey León: Simba
Toy Story: Woody
La Sirenita: Ariel
Shrek: Shrek
Aladdin: Aladdin
La Bella y la Bestia: Bella
Up: Carl Fredricksen
Buscando a Nemo: Nemo
Mulan: Mulan
Wall-E: Wall-E
Los Increíbles: Mr. Increíble
Zootopia: Judy Hopps
Ratatouille: Remy
El Libro de la Selva: Mowgli
Frozen: Elsa
Tangled: Rapunzel
Coco: Miguel
Cars: Rayo McQueen
La Princesa y el Sapo: Tiana
Kung Fu Panda: Po
Anastasia: Anastasia
Los Aristogatos: Duquesa
Tarzán: Tarzán
La Cenicienta: Cenicienta
Pocahontas: Pocahontas
Peter Pan: Peter Pan
La Dama y el Vagabundo: Reina
Hércules: Hércules
Robin Hood: Robin Hood
Bambi: Bambi
Los Tres Caballeros: Pato Donald
La Era del Hielo: Manny
Los Rescatadores: Bernard
La Abeja Maya: Maya
El Gato con Botas: Gato con Botas
Los Pitufos: Pitufo
Dumbo: Dumbo
La Gran Aventura de Winnie the Pooh: Winnie the Pooh
El Zorro y el Sabueso: Tod
La Cigueña Blanca: Lucky