La silla : Der Stuhl
La mesa : Der Tisch
El sofá : Das Sofa
La cama : Das Bett
El armario : Der Schrank
La estantería : Das Regal
El espejo : Der Spiegel
La cortina : Der Vorhang
La alfombra : Der Teppich
La lámpara : Die Lampe
El televisor : Der Fernseher
El refrigerador : Der Kühlschrank
El horno : Der Ofen
El microondas : Die Mikrowelle
El lavavajillas : Der Geschirrspüler
La lavadora : Die Waschmaschine
La secadora : Der Trockner
La cafetera : Die Kaffeemaschine
La tetera : Die Teekanne
La olla : Der Topf
La sartén : Die Pfanne
La cubertería : Das Besteck
La vajilla : Das Geschirr
La copa : Das Glas
La taza : Die Tasse
La botella : Die Flasche
La jarra : Der Krug
El cepillo : Die Bürste
La escoba : Der Besen
La fregona : Der Mopp
La aspiradora : Der Staubsauger
La toalla : Das Handtuch
La sábana : Das Bettlaken
El edredón : Die Bettdecke
La almohada : Das Kissen
El cortaplumas : Die Schere
El destornillador : Der Schraubenzieher
El martillo : Der Hammer
El clavo : Der Nagel
El tornillo : Die Schraube
La bombilla : Die Glühbirne
El enchufe : Die Steckdose
El interruptor : Der Schalter
El radiador : Der Heizkörper
El termostato : Der Thermostat
La chimenea : Der Kamin
El cenicero : Der Aschenbecher
El mantel : Die Tischdecke
La servilleta : Die Serviette
El mantel individual : Das Platzset
El hervidor : Der Wasserkocher
La tostadora : Der Toaster
La batidora : Der Mixer
La licuadora : Der Entsafter
El horno de microondas : Der Mikrowellenherd
El tendedero : Der Wäscheständer
La tabla de planchar : Das Bügelbrett
La plancha : Das Bügeleisen
El despertador : Der Wecker
El radiodespertador : Der Radiowecker
El escurridor : Das Abtropfgestell
La jabonera : Die Seifenschale
El portarrollos de papel higiénico : Der Toilettenpapierhalter